49 50 48 48 60 48 50 51 
49 48 60 50 50 50 48 51 
49 50 60 50 50 50 40 63
49 60 48 50 48 50 51 42 
61 41 50 50 50 50 51 42 
65 49 50 50 50 40 63 64 