42 49 50 50 50 50 50 51 
42 49 50 50 50 50 50 51 
42 49 50 60 50 50 50 51 
42 49 50 50 50 48 40 63 
42 61 41 48 50 40 63 42 
65 42 61 62 62 63 42 64 
